鹌鹑蛋|韭菜:缓解肾虚腰痛阳痿|香菇:面部易长黑斑 ,猪肝:面生黑斑
鹌鹑|辣椒:同食促进食欲|杏鲍菇:可能引起中毒 ,火腿:使面色发黑,五花肉:使面色发黑,排骨:使人面色发黑,猪肉:面生黑斑
白菜薹|芥蓝 :抗癌 |
白菜|蚕豆:增加抵抗力 ,海带:防治碘不足,板栗:去除雀斑和黑眼圈,鲤鱼:改善妊娠水肿 ,辣椒:帮助肠胃消化、提高机体免疫力,栗子:去除雀斑和黑眼圈,鸭肉:促进血液中胆固醇的代谢,鸭腿:促进血液中胆固醇的代谢,牛肚:增强体质,猪肝:滋补,火腿:滋阴润燥,五花肉:滋阴润燥,排骨:滋阴润燥,猪肉:补充营养通便|山竹:身体不适 ,兔肉:腹泻呕吐
白果|薏米:健脾除湿、清热排脓的作用,芦笋:有润肺定喘,杏仁:健脾固肾，收涩止带,羊肉:温补肺气，止咳的作用,羊排:具有温补肺气，止咳的作用|鳗鱼:鳗鱼产生不利于人体的生化反应
百合|糯米:改善气血消除疲劳 ,竹荪:润肺止咳,芦笋:抗癌,银耳:滋阴润肺,鸡蛋:滋阴润燥清心安神|羊骨:腹泻,羊肉:腹泻,火腿:中毒,五花肉:中毒,排骨:中毒,猪肉:一起吃会引起中毒
白萝卜|香干:有利于消化,千张:有利于消化,紫菜:清肺热治咳嗽,豆腐:有利于消化,腐竹:有利于消化,豆腐干:有利于消化,北豆腐:有利于消化,油豆腐:有利于消化,鹅肉:润肺止咳,羊肉:消积滞、化痰热,羊骨:消积滞、化痰热|首乌 :身体不适 ,银耳:易患皮炎,木耳:引发皮炎,丝瓜:伤元气,藕:生食寒性较大,菠萝:身体不适,猪腰:影响消化,胡萝卜:胡萝卜含有抗坏血酸酶，会破坏白萝卜中的维生素C，使两种萝卜的营养价值都大为降低。
板栗|白菜:去除雀斑和黑眼圈,鸡肉:补血养身,鸡胸肉:补血养身,仔鸡:补血|牛肉酱:栗子中的维生素易与牛肉中的微量元素发生反应，削弱栗子的营养价值，而且不易消化 ,杏仁:一起吃会胃痛,羊骨:二者都不易消化，同炖共炒都不相宜，甚至可能同吃还会引起呕吐,羊肉:二者都不易消化，同炖共炒都不相宜，甚至可能同吃还会引起呕吐,牛里脊:同食削弱栗子的营养价值、不易消化,牛腩:引起呕吐,牛排:呕吐,牛肉:栗子中的维生素易与牛肉中的微量元素发生反应，削弱栗子的营养价值，而且不易消化
鲍鱼|竹笋: 营养全面，易于吸收|牛肝:易发生消化不良 ,鸡肉:影响消化吸收,鸡胸肉:影响消化吸收,仔鸡:影响消化吸收
鲅鱼|豆腐:促进蛋白的吸收|牛肝:易出现消化不良 
北豆腐|带鱼:补钙,海带:预防碘缺乏,白萝卜:有利于消化|蜂蜜:有损听力，腹泻 
扁豆|山药:补脾益肾|
比目鱼|豆腐:增加蛋白质的吸收率 ,胡萝卜:防癌抗癌|豆腐:增加蛋白质的吸收率 
冰糖|银耳:滋补润肺,梨:补充津液|
荸荠|木耳:补气强身,香菇:益胃助食,核桃:有利于消化|
菠菜|花生酱:有利于维生素的吸收,粉丝:促进营养素的吸收,海带:防止结石,鸡蛋:提高维生素B12的吸收,茄子:加快血液循环预防癌症,花生:有利于维生素的吸收,杨桃:可防止细胞氧化，还有助于防老抗癌,猪肝:防治贫血|梅花肉:影响营养素的吸收,牛奶:一起吃会引起痢疾 ,蜂蜜:引起心痛 ,豆腐:菠菜中的草酸与豆府中的钙形成草酸钙，使人体的钙无法吸收 ,奶酪:菠菜含丰富的钙质，乳酪所含的化学成份会影响钙的消化吸收 ,鳝鱼:一起吃易导致腹泻,黄鳝:腹泻 ,黄豆:食物中的维生素C会对铜的析放量产生抑制作用 ,韭菜:腹泻 ,黄瓜:菠菜中的维生素C会被黄瓜中的分解酶破坏,猪肉:减少铜的吸收,大豆:食物中的维生素C会对铜的析放量产生抑制作用。,乳酪: 菠菜含丰富的钙质，乳酪所含的化学成份会影响钙的消化吸收。
薄荷|鲫鱼:可治小儿久咳,鸡肉:可起到消火解暑的功效,豆腐:可治疗伤风鼻塞，打喷嚏，流鼻涕等症 ,粳米:具清新怡神，疏风散热增过食欲，帮助消化的功效|甲鱼 :易导致中毒 
菜花|牛肉酱:帮助吸收维生素B12,玉米面:健脾益胃、补虚、助消化 ,西红柿:降血脂降血压,圣女果:降血脂降血压,牛里脊:帮助吸收维生素B12,牛腩:帮助吸收维生素B12,牛肉:帮助吸收维生素B12,猪肉:提高蛋白质的吸收率|笋瓜:破坏维生素C的吸收 ,香椿:因为香椿中含有丰富的钙质，而菜花中所含的化学成分会影响到钙质的消化和吸收。所以，香椿不适宜和菜花一同食用。 ,黄瓜:花菜中的维生素C会被黄瓜中的分解酶破坏,猪肺:身体不适,猪肝:菜花含有大量纤维素，纤维素中的醛糖酸残基可与猪肝中的铁、铜、锌等微量元素形成螯合物而降低人体对这些元素的吸收。,牛奶:牛奶含丰富的钙质，菜花所含的化学成份影响钙的消化吸收。
蚕豆|白菜:增加抵抗力 ,枸杞:清肝去火|红螺:腹胀 ,扇贝:降低锌的吸收量 ,海螺 :腹胀 ,田螺:同食会肠绞痛。
草莓|牛奶:有助于维生素B12的吸收|
糙米|青椒:防止维生素C被氧化,红薯:减肥|
草鱼|豆腐:补中调胃利水消肿促进骨骼发育 ,木耳:促进血液循环|驴肉:引发心脑血管疾病
茶树菇|鸡肉:促进蛋白质的吸收,鸡胸肉:促进蛋白质的吸收,仔鸡:增进蛋白质吸收|
橙子|蜂蜜:同食可用于治胃气不和、呕逆少食|河蚌:变成砒霜 ,牛奶:影响消化，引起腹胀、腹痛、腹泻,蛤蜊:影响维生素C的吸收,槟榔:身体不适,虾:同食会引起中毒、危及生命
赤小豆|糯米:改善脾虚腹泻和水肿,冬瓜:消除全身水肿|鲤鱼:缓解脚气病，利尿 ,羊骨:同食会引起中毒,羊排:两者功能反之，因此不宜搭配一起吃。,羊肉:同食会引起中毒
春笋|木耳:补血|
醋|桑葚:预防感冒、益肾、帮助消化、预防便秘等功效 |豌豆:消化不良 ,水芹菜:损伤牙齿 ,芹菜:损伤牙齿 ,胡萝卜:胡萝卜素就会完全被破坏了,羊骨:羊肉大热，功能益气补虚；醋中含蛋白质、糖、维生素、醋酸及多种有机酸，其性酸温，消肿活血，应与寒性食物配合，与羊肉不宜,羊排:同食会助热发燥，并且还影响羊肉的味道,牛奶:同食会引起腹中病结，可以用地浆水治疗。,羊肉:羊肉大热，功能益气补虚；醋中含蛋白质、糖、维生素、醋酸及多种有机酸，其性酸温，消肿活血，应与寒性食物配合，与羊肉不宜。
大白菜|鲤鱼 :改善妊娠水肿,海带:防治碘不足 ,栗子:去除雀斑和黑眼圈,猪肝:滋补,猪肉:补充营养通便|
大葱|海虾:可起到益气，下乳的功效，尤其适合产后缺乳的女士食用,北极虾:可起到益气，下乳的功效，尤其适合产后缺乳的女士食用,明虾:可起到益气，下乳的功效，尤其适合产后缺乳的女士食用,基围虾:可起到益气，下乳的功效，尤其适合产后缺乳的女士食用,樱桃:治疗麻疹|苦菊:影响营养素的吸收 ,枣:同食易使火气更大,杨梅:同食会产生化学反应，具有不良作用,大蒜:同食会伤胃
大豆|小米:小米的氨基酸中缺乏赖氨酸，而大豆的氨基酸中富含赖氨酸，可以补充小米的不足|藕带: 影响人体对铁的吸收 ,菠菜:食物中的维生素C会对铜的析放量产生抑制作用。
大花蟹|枸杞:补肾壮阳,芦笋:强化骨骼 ,冬瓜:养精益气|苋菜:肠胃积滞 ,石榴:腹疼，呕吐、恶心 ,橘子:气滞肚胀 ,南瓜:中毒 ,柚子:刺激肠胃 ,红薯:胆结石 ,甜瓜:腹泻 ,柿子:腹泻、腹痛，中毒 ,梨:不利于肠胃 ,猕猴桃:中毒 
带鱼|香干:补钙 ,千张:补钙,豆腐:补钙,豆腐干:补钙,腐竹:补钙,油豆腐:补钙,北豆腐:补钙,木瓜:补气养血|
大麦|枣:同食可以增进营养吸收|
当归|桂圆:补血补气|
刀豆|羊肉:补肾壮阳,羊骨:补肾壮阳 |猪肉:易发生腹胀，腹泻
大蒜|玉米面:养心健胃,洋葱:防癌抗癌抗菌消炎,火腿:增进营养元素吸收,五花肉:可增进营养元素的吸收,排骨:增进营养元素吸收,猪肉:促进血液循环、消除疲劳|芒果:身体不适,鸭肉:中毒,鸡肉:大蒜辛温有毒，主下气消谷、除风杀毒而鸡肉甘酸温补，两者功用相佐，且蒜气熏臭，从调味角度讲，也与鸡不合,鸡胸肉:大蒜辛温有毒，主下气消谷、除风杀毒而鸡肉甘酸温补，两者功用相佐，且蒜气熏臭，从调味角度讲，也与鸡不合,鸡翅:两者功用相佐,大葱:同食会伤胃
大枣|香芋:大枣具有健脾、益气、补血的功效，能够使血脉通畅，增加皮肤的营养，两者搭配在一起，相得益彰|海蟹:同食容易患寒热病。
大闸蟹|冬瓜:养精益气,芦笋:强化骨骼,枸杞:补肾壮阳|苋菜:肠胃积滞 ,石榴:腹疼，呕吐、恶心 ,芦柑:气滞肚胀,南瓜:中毒 ,柚子:刺激肠胃 ,红薯:胆结石 ,甜瓜:腹泻 ,柿子:腹泻、腹痛，中毒 ,梨:不利肠胃 ,猕猴桃:中毒 
鲷鱼|豆腐:促进蛋白质的吸收 |西瓜:引起胃肠不适
帝王蟹|芦笋:强化骨骼|梨:不利于肠胃,柿子:生成鞣酸钙，刺激肠胃并引起不适感，出现肚子痛、呕吐、恶心或腹泻等症状，含有较多鞣酸的水果还有葡萄、石榴、山楂等 
冬虫夏草|鸡肉:改善身体虚弱、补肾养肝，调理疾病等功效|绿豆:导致冬虫夏草的营养流失 ,胡萝卜:影响冬虫夏草的吸收利用 
冬瓜|蜜豆:能消除全身浮肿。,大花蟹:养精益气,大闸蟹:养精益气,青蟹:养精益气,猪小排:祛湿,甲鱼:润肤明目减肥,豇豆:豇豆和冬瓜一起吃，具有补肾消肿的作用，并且对于肾炎、腰痛和浮肿患者有一定的治疗功效。,口蘑:利湿,赤小豆:消除全身水肿,平菇:利湿,椰子:泻肺火,鸡肉:消肿清热利尿,鸡胸肉:消肿清热利尿,仔鸡:消肿清热利尿,火腿:蛋白质更容易吸收,五花肉:利于蛋白质的消化吸收,排骨:蛋白更易吸收|红螺:身体不适 ,山竹:身体不适,海螺:身体不适,鲫鱼:同食会使身体脱水。
冬菇|燕麦片:有助于防癌、抗衰老 |
冬笋|猪肉:补肝肾|甲鱼:伤元气
豆豉|鸭肉:降低人体脂肪,鸭翅:降低人体的脂肪含量|
豆腐干|带鱼:补钙,白萝卜:有利于消化|
豆腐|萝卜干:帮助人体吸收营养,薄荷:可治疗伤风鼻塞，打喷嚏，流鼻涕等症 ,芸豆 :适宜慢性肝炎,鲷鱼:促进蛋白质的吸收 ,秋刀鱼:促进钙的吸收,鲢鱼:补充钙质,桂鱼:促进钙的吸收,鲅鱼:促进蛋白的吸收,鳗鱼:增加蛋白质的吸收 ,黄鱼 :可提高人体对钙的吸收率 ,鳕鱼:蛋白质的吸收率,带鱼:补钙,鲈鱼:增加蛋白质的吸收,鲫鱼 :清心润肺健脾利胃,草鱼:补中调胃利水消肿促进骨骼发育 ,比目鱼 :增加蛋白质的吸收率 ,文蛤:去热寒、治气血不足、皮肤粗糙,蛤蜊:去热寒,海虾:容易消化，对高血压，高脂血，动脉粥样硬化的肥胖者尤宜，更适合老年肥胖者食用 ,北极虾:容易消化，对高血压，高脂血，动脉粥样硬化的肥胖者尤宜，更适合老年肥胖者食用,明虾:容易消化，对高血压，高脂血，动脉粥样硬化的肥胖者尤宜，更适合老年肥胖者食用 ,基围虾:容易消化，对高血压，高脂血，动脉粥样硬化的肥胖者尤宜，更适合老年肥胖者食用,平菇:增加蛋白质的吸收,金针菇:增加抵抗力,海带 :预防碘缺乏,水芹菜:清肠排毒,油麦菜:镇痛催眠,青萝卜:帮助人体吸收豆腐中的营养,瓠瓜:美容减肥,西葫芦:减肥美容 ,荠菜:清热降压,生菜:减肥健美,油菜:清肺止咳,辣椒:益智美容、健脑,白萝卜:有利于消化,桂花:有丰胸的作用,羊排:能够补充人体多类微元素，并且还能够起到清热泻火，除烦，止渴的作用。 ,羊肉:清热泻火、除烦、止渴,羊骨:清热泻火、除烦、止渴 |比目鱼:增加蛋白质的吸收率 ,蜂蜜: 形成草酸钙，造成了对钙的吸收困难，导致人体内钙质的缺乏 ,小葱:形成草酸钙，造成了对钙的吸收困难，导致人体内钙质的缺乏 ,菠菜:菠菜中的草酸与豆府中的钙形成草酸钙，使人体的钙无法吸收 ,茭白:易形成结石,猪血:补血
豆角|土豆:防止急性肠胃炎呕吐腹泻|
豆苗|海虾:吃对体质阴寒，低血压，食欲不佳，精力衰退者都有较好的食疗效果,北极虾:吃对体质阴寒，低血压，食欲不佳，精力衰退者都有较好的食疗效果,明虾:吃对体质阴寒，低血压，食欲不佳，精力衰退者都有较好的食疗效果,基围虾:吃对体质阴寒，低血压，食欲不佳，精力衰退者都有较好的食疗效果|羊肉:易发生黄疸和脚气病 
对虾|燕麦:护心解毒|
杜仲|山楂干:降血压,山楂:降血压|
鹅肉|白萝卜:润肺止咳|红啤梨:鹅肉与鸭梨不可同食，同食产生不良生化反应，伤及肾脏。,柿子:一起吃严重会导致死亡,鸡蛋:一起吃伤元气,鸭梨:伤肾脏
肥牛|鸡蛋:可以提供可观的人体所需的优质蛋白质，可以调节人体代谢新陈，增强机体抗病毒能力。,甘蔗:可以气血双补，健脾开胃,萝卜:同食可为人体提供可观的蛋白质，维生素C等营养成份，具有补五脏，益气血的作用。,莴苣:同食有调理气血的作用,芋头:具有益气补中，通便的作用。,茄子:同食可以强壮身体,土豆:同食不仅味道好，并且马铃薯富含叶酸，有着保护胃黏膜的功效。,牛蒡:同食可刺激胃肠蠕动，改善便秘等症状|牛膝:牛膝可治血热卜炎之咽喉肿疼，吐血，衄血，高血压性头疼等症，而牛肉甘温，补气助火，二者不宜同用。,生姜:同食会上火,红糖:同食会引起肚胀,田螺:同食不容易消化，会引起肚胀。
蜂蜜|牛奶:缓解贫血和痛经 ,茼蒿:预防便秘 ,黄瓜:润肠通便,胡萝卜:排毒,桑葚:可滋阴补血、适用于阴血亏虚所致的须发早白、头目晕眩、女子月经不调、闭经等。,橙子:同食可用于治胃气不和、呕逆少食,梨:缓解咳嗽|鹅蛋:产生毒素 ,油豆腐:有损听力，腹泻,香干:有损听力，腹泻 ,豆浆:鸡蛋中黏液性蛋白易和豆浆中的胰蛋白酶结合，产生一种不能被人体吸收的物质大大降低了人体对营养的吸收 ,腐竹:有损听力，腹泻 ,北豆腐:有损听力，腹泻 ,豆腐: 形成草酸钙，造成了对钙的吸收困难，导致人体内钙质的缺乏 ,米饭:影响消化吸收 ,螃蟹:中毒 ,河蟹:一起吃会引起中毒，可以用地浆水治疗 ,生菜:一起吃易导致腹泻 ,菠菜:引起心痛 ,莴笋:不利肠胃，易致腹泻,茭白:引发痼疾,李子:有损五脏,洋葱:同食会伤眼睛，引起眼睛不适，严重会失明。,韭菜:同食会阻碍血液循环。,鲫鱼:同食会中毒。,大米: 同食会胃痛。
粉丝|菠菜:促进营养素的吸收|
腐竹|带鱼 :补钙,西芹 :抗疲劳 ,白萝卜:有利于消化|蜂蜜:有损听力，腹泻 ,小葱: 影响钙质的吸收 
干贝|鸡蛋:营养全面|
甘蔗|山药:咳嗽有痰者，二者同食对身体非常有好处,牛肉:可以气血双补，健脾开胃,牛奶:能够降低甘蔗汁的寒性,粟米:适用于脾肺不足、阴虚肺燥、烦热咳嗽、咽喉不利等症 ,高粱:益气生津、对痰热咳嗽、口舌干燥、唾液黏涎有食疗作用,肥牛:可以气血双补，健脾开胃|
高粱|甘蔗:益气生津、对痰热咳嗽、口舌干燥、唾液黏涎有食疗作用|
粳米|薄荷:具清新怡神，疏风散热增过食欲，帮助消化的功效,小米面:同食可提高营养价值,香芋:有散结宽肠、健脾强肾、下气等作用，常食可养颜，适用于大便干燥、便结等症,桑葚:同食可补肝益肾、养血润燥、消除脑力疲劳、常吃有利于记忆力减退、精力不集中、多梦、失眠等症状的改善。|
鸽子|玉米:防治神经衰弱|
枸杞|大花蟹:补肾壮阳,青蟹:补肾壮阳 ,大闸蟹:补肾壮阳,山楂干:补肝益肾 ,山楂:补肝益肾,羊排:比较适用于肾精衰败，腰背疼痛，性功能减退等。,决明子:清肝明目,蚕豆:清肝去火,银耳:美容养颜|绿茶:绿茶里所含的大量鞣酸具有收敛吸附的作用，会吸附枸杞中的微量元素，生成人体难以吸收的物质
桂花|糯米:食欲不佳，腹胀腹泻有一定缓解作用,豆腐:有丰胸的作用,菊花:清热润肺，养颜美白，清肝明目的功效|
桂圆|小米面:同食有益丹田，补虚损，开肠胃之作用,大米:补元气,当归:补血补气,鸡蛋:补气养血|
桂鱼|丝瓜:营养均衡,豆腐:促进钙的吸收|山楂:腹痛、恶心、呕吐 ,西红柿:影响铜的吸收 ,枣:消化不良 ,毛豆:维生素B族破坏 
海带|豆腐:预防碘缺乏,油豆腐:预防碘缺乏 ,大白菜:防治碘不足 ,北豆腐:预防碘缺乏,生菜:促进铁的吸收,菠菜:防止结石,白菜:防治碘不足,芝麻:血液循环净化血液降低胆固醇|柿子:胃肠不适,猪血:同食会便秘。
海螺|藕:补气|牛肉酱:身体不适 ,玉米面:身体不适 ,蚕豆:腹胀 ,玉米:身体不适,木耳 :腹胀 ,冬瓜:身体不适,香瓜:身体不适,羊骨:腹泻,羊肉:腹泻,牛里脊:身体不适,牛肉:身体不适,猪肉:身体不适
北极虾|油菜:可提供更多人体所需的钙质,芹菜:够促进人体代谢新陈，改善机体微循环,韭菜:补益肝肾的作用,大葱:可起到益气，下乳的功效，尤其适合产后缺乳的女士食用,辣椒:有利于提高人体免疫力，并且具有开胃，消食，壮阳的作用,豆苗:吃对体质阴寒，低血压，食欲不佳，精力衰退者都有较好的食疗效果,鸡蛋:味道与营养均会明显提升 ,茄子:营养非常高，具有健脾宁心，降压止血的作用。比较适用于动脉硬化，高血压，脑血栓形成和坏血病患者食用 ,豆腐:容易消化，对高血压，高脂血，动脉粥样硬化的肥胖者尤宜，更适合老年肥胖者食用,丝瓜:辅助治疗肺虚咳嗽，体倦，腰膝酸软等病患 |柿子:生成鞣酸钙，刺激肠胃并引起不适感，出现肚子痛、呕吐、恶心或腹泻等症状，含有较多鞣酸的水果还有葡萄、石榴、山楂等 ,猪肉:耗人阴精，造成阴虚火旺，不利于身体健康 ,黄豆:易引起消化不良 ,鸡肉:性味互相抵触，降低营养价值 ,香菇:香菇含有大量异种蛋白，容易引起过敏，而香菇又被列为气喘的引起物之一，两者不宜搭配同吃，哮喘病人尤要注意 ,南瓜:同食会引起痢疾 ,木瓜:生成有毒物质 
鲳鱼|青椒:促进维生素C的吸收 |羊骨:影响营养素的吸收,羊肉:影响营养素的吸收
大米|胡萝卜:改善胃肠功能,桂圆:补元气|蕨菜:降低维生素B1的消化吸收 ,蜂蜜: 同食会胃痛。
豆瓣酱|牡蛎 :去腥|羊排:两者功能反之，提议最好不要搭配一起吃
芥蓝|白菜薹:抗癌 |
海米|圆白菜:补充碘|
红豆|糯米:改善脾虚腹泻和水肿 ,鲤鱼:消水肿,枣:同食起到补益、心脾、消肿、利水的功效|羊肝:一起吃会引起中毒,羊肚:同食会引起中毒。
胡椒面|羊排:同食具有温肺化痰的作用|
金针菇|豆腐:增加抵抗力,西兰花:防癌抗癌,油菜:预防大肠癌和胃癌|牛奶:消化不良 ,驴肉:一起吃会引起心痛，严重会致命
菊花|银耳:润燥除烦 ,桂花:清热润肺，养颜美白，清肝明目的功效|梅花肉:中毒,鸡胸肉:一起吃会中毒,鸡翅:中毒,仔鸡:中毒,火腿:中毒,五花肉:中毒,排骨:中毒,猪肉:一起吃严重会导致死亡,芹菜:同食会引起呕吐,鸡肉:同食会中毒。
栗子|鸡肉:补血养身,白菜:去除雀斑和黑眼圈,大白菜:去除雀斑和黑眼圈,枣:适于肾虚、腰酸背痛者、腿脚无力者、小便频多者,鸭肉:影响营养吸收|牛肉:栗子中的维生素易与牛肉中的微量元素发生反应，削弱栗子的营养价值，而且不易消化,牛腩:引起呕吐,羊肉:二者都不易消化，同炖共炒都不相宜，甚至可能同吃还会引起呕吐,鸭翅:影响营养吸收,羊排:会造成胃肠不适感，呕吐,牛排:呕吐,杏仁: 同食会胃痛。
海参|羊肉:养血润燥,羊骨:养血润燥|山楂干:不易消化,柿子:不易消化,山楂:不易消化,石榴:不易消化
海虾|油菜:可提供更多人体所需的钙质 ,芹菜:够促进人体代谢新陈，改善机体微循环 ,韭菜:补益肝肾的作用,大葱:可起到益气，下乳的功效，尤其适合产后缺乳的女士食用,辣椒:有利于提高人体免疫力，并且具有开胃，消食，壮阳的作用 ,豆苗:吃对体质阴寒，低血压，食欲不佳，精力衰退者都有较好的食疗效果,鸡蛋:味道与营养均会明显提升 ,茄子:营养非常高，具有健脾宁心，降压止血的作用。比较适用于动脉硬化，高血压，脑血栓形成和坏血病患者食用,豆腐:容易消化，对高血压，高脂血，动脉粥样硬化的肥胖者尤宜，更适合老年肥胖者食用 ,丝瓜:辅助治疗肺虚咳嗽，体倦，腰膝酸软等病患 |柿子:生成鞣酸钙，刺激肠胃并引起不适感，出现肚子痛、呕吐、恶心或腹泻等症状，含有较多鞣酸的水果还有葡萄、石榴、山楂等 ,猪肉:耗人阴精，造成阴虚火旺，不利于身体健康 ,黄豆:易引起消化不良 ,鸡肉:性味互相抵触，降低营养价值 ,香菇:香菇含有大量异种蛋白，容易引起过敏，而香菇又被列为气喘的引起物之一，两者不宜搭配同吃，哮喘病人尤要注意 ,南瓜:同食会引起痢疾 ,木瓜:生成有毒物质 
海蜇头|木耳 :润肠美肤嫩白降压 |柿子:腹胀
海蜇|木耳:润肠美肤嫩白降压|柿子:腹胀 
蛤蜊|豆腐:去热寒|田螺:腹胀 ,水芹菜:影响维生素的吸收 ,芹菜:影响维生素的吸收 ,橙子:影响维生素C的吸收
黑豆|红糖:滋补肝肾 活血行经 美容乌发,牛奶:帮助人体更好地吸收牛奶中的维生素B12|
黑木耳|桔子:治疗痛经,乌鸡:活血补血|
黑鱼|首乌:可以治疗疮疡，瘰疬，精血不足，便秘等症|茄子:同食有损肠胃
荷兰豆|红糖:健脾 通乳 利水,蘑菇:消除油脂引起的食欲不佳|
核桃|水芹菜:润发明目养血 ,荸荠:有利于消化,芹菜:润发明目养血,芝麻:改善皮肤弹性，保持皮肤细腻,枣:提供全面的营养物质、具有美容养颜作用|山鸡:肺炎、支气管炎患者忌食
河虾|燕麦:护心解毒|洋葱:形成草酸钙产生结石,柿子:腹泻
红螺|藕:补气|羊肉:腹泻 ,冬瓜:身体不适 ,玉米:身体不适 ,木耳:腹胀 ,蚕豆:腹胀 ,香瓜:身体不适 ,猪肉:身体不适 ,牛肉:身体不适 
红薯|水芹菜:降血压,芹菜:降血压,猪小排:增加营养素的吸收,糙米:减肥,莲子:适合习惯性便秘和慢性肝炎患者|大花蟹 :胆结石 ,青蟹:胆结石 ,大闸蟹:胆结石 ,梭子蟹:形成胆结石 ,圣女果:同食会得结石病、呕吐、腹痛、腹泻 ,西红柿:一起吃会得结石病，呕吐、腹痛、腹泻,鸡蛋:一起吃会腹痛,柴鸡:同食会腹痛,螃蟹:容易在体内凝成柿石,河蟹:结石,柿子:腹胀,香蕉:一起吃会引起身体不适,鸡肉:同食会腹痛,鸡胸肉:同食会腹痛,鸡翅:同食会腹痛,仔鸡:腹痛
红糖|黑豆:滋补肝肾 活血行经 美容乌发,荷兰豆:健脾 通乳 利水,小米面:同食可以健脾胃，补虚损，排除淤血，补充失血 ,小米:补虚补血|文蛤:同食会引起中毒 ,竹笋: 形成赖氨酸糖基，对人体不利 ,牛里脊:不利于营养的吸收、腹胀,肥牛:同食会引起肚胀,牛腩:腹胀,牛排:不利于营养的吸收；,皮蛋:同食会引起中毒。,牛肉:同食会引起腹胀。
黄豆芽|鲫鱼:通乳汁|猪血:一起吃会消化不良,猪肝:有损营养素的吸收
黄豆|鸡蛋:降低胆固醇,小米:有利于营养素的吸收,小米面:同食可提高蛋白质的吸收利用率,燕麦片:预防贫血|梅花肉:腹胀,酸奶:酸牛奶含丰富的钙质，黄豆所含的化学成份影响钙的消化吸收 ,虾皮:一起吃会消化不良 ,基围虾:易引起消化不良 ,明虾:易引起消化不良 ,北极虾:易引起消化不良 ,海虾:易引起消化不良 ,水芹菜:降低铁的吸收 ,芹菜:降低铁的吸收 ,菠菜:食物中的维生素C会对铜的析放量产生抑制作用 ,猪蹄:腹胀,排骨:胀气,猪肉:腹胀,猪血:同食会消化不良。
黄瓜|蜂蜜:润肠通便|花生酱:一起吃易导致腹泻 ,水芹菜:芹菜中的维生素C将会被分解破坏，降低营养价值 ,辣椒:降低营养价值、破坏维生素C,芹菜:芹菜中的维生素C将会被分解破坏，降低营养价值,圣女果:破坏维生素C的吸收,青椒:破坏维生素C,枇杷:影响消化,香椿:黄瓜中含有维生素C分解酶，会破坏到香椿中的维生素C，影响人体对维生素C的吸收，使营养大大降低，故香椿和黄瓜也不宜同食。,菜花:花菜中的维生素C会被黄瓜中的分解酶破坏,香菜:破坏维生素C,菠菜:菠菜中的维生素C会被黄瓜中的分解酶破坏,油菜:降级维生素C的吸收,山药:黄瓜中含维生素c分解酶，若山药同食，维生素c则被分解破坏。,圆白菜:影响维生素C的吸收,芦柑:柑橘中的维生素C会被黄瓜中的分解酶破坏,小白菜:破坏维生素C,花生:一起吃易导致腹泻,金桔:同食会使金桔的营养价值降低,枣:破坏维生素 C,樱桃:破坏维生素C，失去营养价值,杨梅:失去原有的营养价值,杏:身体不适
黄鳝|藕:滋阴健脾|皮蛋:导致腹泻，也会引起食物中毒 ,菠菜:腹泻 ,南瓜:身体不适
黄鱼|苹果:有助于营养的全面补充,荠菜:二者搭配是孕妇防治缺铁性贫血的保健菜肴 ,豆腐:可提高人体对钙的吸收率 ,苔菜:提供较高的营养成分,有润肺健脾、补气活血、清热解毒之功效。对产后体弱虚损、腰肌劳损有一定作用|荞麦:消化不良 
花生酱|苦菊:清热解毒凉血止血,菠菜:有利于维生素的吸收|黄瓜:一起吃易导致腹泻 ,河蟹:一起吃易导致腹泻 ,螃蟹:一起吃易导致腹泻 
花生|鲤鱼:有利于营养的吸收,鲫鱼:有利于吸收营养,苦菊:清热解毒凉血止血 ,菠菜:有利于维生素的吸收,猪蹄:催乳,枣:补虚、止血|河蟹: 一起吃易导致腹泻,螃蟹:腹泻,黄瓜:一起吃易导致腹泻
瓠瓜|豆腐:美容减肥|芦笋:加重脾胃虚寒 
胡萝卜|比目鱼:防癌抗癌,大米:改善胃肠功能,蜂蜜:排毒,圆白菜:减少癌细胞的产生,羊排:同食适于营养不良、贫血、头晕、大便干燥的病人、可以补虚益气、增进血液循环、提高御寒能力，还能帮助消化、补肾壮阳。|山药:胡萝卜中含维生素c分解酶，若山药同食，维生素c则被分解破坏。,冬虫夏草:影响冬虫夏草的吸收利用 ,辣椒:降低营养价值、影响维生素C的吸收,醋:胡萝卜素就会完全被破坏了,水萝卜:萝卜主泻、胡萝卜为补，所以二者最好不要同食,山楂干:维生素C则易被分解破坏,樱桃:降低各自原有的营养价值,杏:身体不适,山楂:胡萝卜富含维生素C分解酶，若含有丰富的维生素C的山楂与含有维生素C分解酶的食物同用，维生素C则易被分解破坏。,白萝卜:胡萝卜含有抗坏血酸酶，会破坏白萝卜中的维生素C，使两种萝卜的营养价值都大为降低。
火腿|紫菜:滋阴润燥,大蒜:增进营养元素吸收,丝瓜:营养均衡,山楂:能够提高蛋白质的利用率，更易消化,蘑菇:益气补脾，润燥化痰,冬瓜:蛋白质更容易吸收,洋葱:滋阴润燥,萝卜:容易消化吸收,茄子:提高抗病力 ,南瓜:降低血糖,白菜:滋阴润燥|杏仁:易导致腹痛,甘草:不利于肠胃,田螺:伤肠胃，易造成脱发,菊花:中毒,百合:中毒,香菜:耗气伤身,菱角:引起腹痛,鲫鱼:滞气,鹌鹑:使面色发黑
豇豆|绿豆:豇豆和绿豆同煮汤饮服，具有清热解毒的功效，适用于小儿夏季生痱子、小疖肿等病症。,玉米:玉米粥对于脾胃虚弱、尿频遗精、动脉硬化、冠心病、高血脂、高血压病人有着很好的食疗效果，适合这些患者长期食用，玉米粥配上,木耳:豇豆具有解渴健脾、补肾止泻、益气生津的作用；木耳则具有益气养胃润肺、凉血止血和降脂减肥的作用。所以豇豆和木耳一起吃对高,冬瓜:豇豆和冬瓜一起吃，具有补肾消肿的作用，并且对于肾炎、腰痛和浮肿患者有一定的治疗功效。,土豆:豇豆的营养成分能够让人头脑宁静,并且能够对消化系统进行调理,能消除胸膈胀满，所以豇豆和土豆搭配,可以防治急性肠胃炎、防治呕吐、腹泻等,鸡肉:增进食欲,鸡胸肉:增进食欲,仔鸡:增进食欲|
茭白|牛里脊:催乳汁,牛肉:催乳汁|蜂蜜:引发痼疾,豆腐:易形成结石
甲鱼|冬瓜:润肤明目减肥|薄荷:易导致中毒 ,皮蛋:引起食物中毒、呕吐等症状 ,咸鸭蛋:胃肠不适 ,鸭蛋:二物皆属凉性，不宜一起吃 ,鸡蛋:性咸平，孕妇及产后便秘者忌食 ,水芹菜:一起吃会中毒，可以用橄榄汁解毒 ,苋菜:一起吃难以消化 ,冬笋:伤元气,桃:心痛,柿子:消化不良,兔肉:脾胃虚寒者忌食,鸭肉:久食令人阳虚，水肿腹泻,鸭翅:水肿腹泻,芹菜:同食会中毒。
荠菜|黄鱼:二者搭配是孕妇防治缺铁性贫血的保健菜肴 ,豆腐:清热降压,鸡蛋:缓解眩晕头痛|
鸡翅|青椒:补充维生素C,蘑菇:促进蛋白质的吸收|李子:食则拉痢,芝麻:严重会导致死亡,菊花:中毒,红薯:同食会腹痛,糯米:引起身体不适,大蒜:两者功用相佐
鸡蛋|西红柿:缺乏维生素C是鸡蛋唯一的‘短处’，搭配番茄就可以弥补。,辣椒:有利于维生素的吸收 ,黄豆:降低胆固醇,玉米:防止胆固醇过高,小米面:同食用有补脾胃，益气血，活血脉的作用,小米:整体改善蛋白质的吸收。,银鱼:增加蛋白质的吸收,牡蛎 :促进骨骼生长 ,干贝:营养全面,海虾:味道与营养均会明显提升 ,北极虾:味道与营养均会明显提升 ,明虾:味道与营养均会明显提升,基围虾:味道与营养均会明显提升,紫菜:有利于营养素的吸收,苋菜:增强人体免疫力,香椿:润滑肌肤,荠菜:缓解眩晕头痛,茼蒿:帮助充分吸收维生素A,生菜:滋阴润燥清热解毒,菠菜:提高维生素B12的吸收,韭菜:补肾行气,丝瓜:润肺补肾美肤 ,百合:滋阴润燥清心安神,洋葱:提高人体对维生素c和维生素E的吸收率 ,桂圆:补气养血,羊排:搭配食用可滋补身体，增强新陈代谢,肥牛:可以提供可观的人体所需的优质蛋白质，可以调节人体代谢新陈，增强机体抗病毒能力。,青椒:缺乏维生素C是鸡蛋唯一的“短处”，搭配青椒等，就可以弥补。|鹅蛋:同食伤元气 ,鹅:损伤脾胃 ,甲鱼 :性咸平，孕妇及产后便秘者忌食 ,红薯:一起吃会腹痛,柿子:腹泻、生结石,桔子:影响蛋白质的消化吸、产生不良症状,菠萝:鸡蛋中的蛋白质与菠萝中的果酸结合，易使蛋白质凝固，影响消化,鹅肉:一起吃伤元气,兔肉:易产生刺激肠胃道的物质而引起腹泻,田鸡:同食容易中毒,地瓜:同食会腹痛。,味精:鸡蛋本身含有许多与味精成份相同的谷氨酸，所以炒鸡蛋时放味精，不仅不能增加鲜味，反而会破坏和掩盖鸡蛋的天然鲜味。,豆浆:蛋清的粘性蛋白同豆浆中的胰蛋白酶结合，使蛋白质的分解受到阻碍，降低人体对蛋白质的吸收,牛奶:鸡蛋里的某种蛋白会和牛奶里的某中营养成分相互反应，使营养价值下降，所以不宜同食。
芥菜|鸡心:增加营养素的吸收量,猪肝:有助于钙的吸收|鲫鱼:引起水肿 
精盐|杨桃:有助于维持人体的酸碱平衡|芒果: 易诱发黄疸
金银花|益母草:清热解毒|
鸡肉|薄荷:可起到消火解暑的功效,首乌:一起吃有补肝养血，滋肾益精的功效,冬虫夏草:改善身体虚弱、补肾养肝，调理疾病等功效,栗子:补血养身,茼蒿:帮助充分吸收维生素A ,冬瓜:消肿清热利尿,豇豆:增进食欲,板栗:补血养身,茶树菇:促进蛋白质的吸收,松子:增加抵抗力,油菜:强化肝脏美化肌肤 |基围虾:性味互相抵触，降低营养价值 ,明虾:性味互相抵触，降低营养价值 ,北极虾:性味互相抵触，降低营养价值 ,海虾:性味互相抵触，降低营养价值 ,芹菜:一起吃会伤元气,红薯:同食会腹痛,兔肉:腹泻,芝麻:一起吃严重会导致死亡,芥末酱:两者共食，恐助火热，无益于健康,大蒜:大蒜辛温有毒，主下气消谷、除风杀毒而鸡肉甘酸温补，两者功用相佐，且蒜气熏臭，从调味角度讲，也与鸡不合,鲍鱼:影响消化吸收,鲤鱼:性味不反但功能相乘,糯米:同食会引起身体不适。,李子:同食会引起痢疾,菊花:同食会中毒。
鸡腿菇|竹荪:提高营养素的吸收率|
鸡腿|香菇:提供高质量蛋白质|芝麻:影响维生素的吸收,鲤鱼:容易引起身体不适
韭菜|青鱼:治疗脚气 ,海虾:补益肝肾的作用,北极虾:补益肝肾的作用,明虾:补益肝肾的作用,基围虾:补益肝肾的作用,鹌鹑蛋:缓解肾虚腰痛阳痿,鸡蛋:补肾行气|虾皮:影响营养的吸收 ,蒜薹: 影响消化 ,菠菜:腹泻 ,牛里脊:中毒,牛排:中毒,牛肉:同食容易中毒。,蜂蜜:同食会阻碍血液循环。,牛奶:牛奶中含钙。牛奶与含草酸多的韭菜混合食用,就会影响钙的吸收。
韭黄|平菇:对增进食欲，缓解消化不良有效，还可解毒 |
基围虾|油菜:可提供更多人体所需的钙质,芹菜:够促进人体代谢新陈，改善机体微循环,韭菜:补益肝肾的作用,大葱:可起到益气，下乳的功效，尤其适合产后缺乳的女士食用,辣椒:有利于提高人体免疫力，并且具有开胃，消食，壮阳的作用,豆苗:吃对体质阴寒，低血压，食欲不佳，精力衰退者都有较好的食疗效果,鸡蛋:味道与营养均会明显提升,茄子:营养非常高，具有健脾宁心，降压止血的作用。比较适用于动脉硬化，高血压，脑血栓形成和坏血病患者食用 ,豆腐:容易消化，对高血压，高脂血，动脉粥样硬化的肥胖者尤宜，更适合老年肥胖者食用,丝瓜:辅助治疗肺虚咳嗽，体倦，腰膝酸软等病患|柿子:生成鞣酸钙，刺激肠胃并引起不适感，出现肚子痛、呕吐、恶心或腹泻等症状，含有较多鞣酸的水果还有葡萄、石榴、山楂等 ,猪肉:耗人阴精，造成阴虚火旺，不利于身体健康 ,黄豆:易引起消化不良 ,鸡肉:性味互相抵触，降低营养价值 ,香菇:香菇含有大量异种蛋白，容易引起过敏，而香菇又被列为气喘的引起物之一，两者不宜搭配同吃，哮喘病人尤要注意 ,南瓜:同吃会引起痢疾 ,木瓜:生成有毒物质 
鸡心|芥菜:增加营养素的吸收量|李子:腹泻
鸡胸肉|茼蒿:帮助充分吸收维生素A,冬瓜:消肿清热利尿,豇豆:增进食欲,板栗:补血养身,茶树菇:促进蛋白质的吸收,松子:增加抵抗力,油菜:强化肝脏美化肌肤 |糯米:引起身体不适 ,芝麻:严重会导致死亡,芹菜:一起吃会伤元气,李子:一起吃会引起痢疾,菊花:一起吃会中毒,红薯:同食会腹痛,兔肉:腹泻,芥末酱:两者共食，恐助火热，无益于健康,大蒜:大蒜辛温有毒，主下气消谷、除风杀毒而鸡肉甘酸温补，两者功用相佐，且蒜气熏臭，从调味角度讲，也与鸡不合,鲍鱼:影响消化吸收,鲤鱼:性味不反但功能相乘
鲫鱼|薄荷:可治小儿久咳,豆腐:清心润肺健脾利胃,绿豆芽:通乳汁,黄豆芽:通乳汁,木耳:补充核酸抗老化,花生:有利于吸收营养|梅花肉:影响营养素的吸收,芥末酱:身体不适 ,猪小排:影响营养素的吸收 ,芥菜:引起水肿 ,猪大排:影响营养素的吸收 ,山药:同食会引起腹痛、恶心、呕吐等症状。,乌鸡:中毒,猪肝:一起吃具有刺激作用，疮痈热病者忌食,火腿:滞气,五花肉:滞气,排骨:滞气,猪肉:二者起生化反应，不利于健康,蜂蜜:同食会中毒。,冬瓜:同食会使身体脱水。
鸡爪|油菜:促进胶原蛋白的吸收|
鸡胗|芡实:治遗精,山药:治小儿脾虚疳积|
决明子|枸杞:清肝明目|
桔子|黑木耳:治疗痛经|豆浆:影响消化吸收,鸡蛋:影响蛋白质的消化吸、产生不良症状,螃蟹:影响蛋白质的消化吸收,兔肉:同食导致腹泻,牛奶:影响消化，引起腹胀、腹痛、腹泻,萝卜:同食会诱发甲状腺肿
口蘑|冬瓜:利湿|味精:鲜味反失
苦瓜|玉米面:清热解暑,辣椒:润肤容颜、抗老防衰、健美、明目,青椒:抗衰老,茄子:对缓解心血管疾病有良好功效 ,洋葱:提高机体的免疫力|山竹:身体不适,猪小排:形成草酸钙阻碍钙的吸收,猪大排:形成草酸钙阻碍钙的吸收
苦菊|花生酱:清热解毒凉血止血,花生:清热解毒凉血止血 |大葱:影响营养素的吸收 
辣椒|鸡蛋:有利于维生素的吸收 ,海虾:有利于提高人体免疫力，并且具有开胃，消食，壮阳的作用 ,北极虾:有利于提高人体免疫力，并且具有开胃，消食，壮阳的作用,明虾:有利于提高人体免疫力，并且具有开胃，消食，壮阳的作用,基围虾:有利于提高人体免疫力，并且具有开胃，消食，壮阳的作用,虾:提高人体免疫力、具有开胃、消食、壮阳的作用,白菜:帮助肠胃消化、提高机体免疫力,鹌鹑:同食促进食欲,小白菜:促进食欲、帮助消化,羊肉:去除羊肉膻味,圆白菜:促进胃肠蠕动、有利于营养物质吸收,豆腐:益智美容、健脑,苦瓜:润肤容颜、抗老防衰、健美、明目,羊排:同食可去除羊肉的膻味|南瓜:影响维生素C吸收,羊肝:破坏维生素C、降低营养价值,猪肝:同食降低营养价值,胡萝卜:降低营养价值、影响维生素C的吸收,黄瓜:降低营养价值、破坏维生素C
蓝莓|酸奶:壮骨，增加免疫力|
鲢鱼|豆腐:补充钙质,藕:美容|甘草:容易引起腹泻 
莲子|南瓜:通便排毒,红薯:适合习惯性便秘和慢性肝炎患者,山药:健脾补肾,木瓜:对缓解高血压冠心病有一定的疗效 |糯米:影响钙的吸收 ,猪肚:易中毒
榴莲|山竹:消火|
梨|冰糖:补充津液,蜂蜜:缓解咳嗽|梅花肉:伤肾脏,大花蟹:不利于肠胃 ,帝王蟹:不利于肠胃,青蟹:不利于肠胃 ,大闸蟹:不利肠胃 ,梭子蟹:一起食用不利于肠胃 ,羊排:同食会造成腹泻，消化不良,猪蹄:伤肾脏,猪肉:伤肾脏,螃蟹:同食会影响肠胃消化。
鲤鱼|蜜豆:有缓解脚气利尿的作用。,红豆:消水肿,香菇:提供全面的营养,米醋:利湿,大白菜:改善妊娠水肿,紫甘蓝 :营养吸收更全面,白菜:改善妊娠水肿 ,花生:有利于营养的吸收,枣:滋补暖胃、强心补血|赤小豆:缓解脚气病，利尿 ,狗肉:二者生化反应极为复杂，可能产生不利于人体的物质 ,山药:同食会引起腹痛、恶心、呕吐等症状。,南瓜:一起吃会中毒,鸡肉:性味不反但功能相乘,鸡胸肉:性味不反但功能相乘,鸡腿:容易引起身体不适,甘草:同食会中毒。,猪肝:同食会影响消化。
荔枝|枣:同食具有健脾止泻的作用|
芦荟|苹果:生津止渴、健脾益胃、消食顺气等功效,木耳:对糖尿病的治疗有很显著的疗效,南瓜:可使面部皮肤由黑变白嫩，由粗糙变细腻 |
萝卜|羊排:同食有比较好的益智健脑的作用，具有助阳，补精，消食，顺气的作用，使补而不滞，适于身体虚弱的人食用。,肥牛:同食可为人体提供可观的蛋白质，维生素C等营养成份，具有补五脏，益气血的作用。,火腿:容易消化吸收,五花肉:易消化吸收,排骨:更容易消化吸收|阿胶:萝卜属于顺气和促消化的食物，而阿胶是补气的，一起服用的话会相抵，大大降低了阿胶的功效，起不到补血、补气的作用 ,首乌:性寒滑 ,金桔:同食会诱发或导致甲状腺肿,枣:破坏维生素 C,桔子:同食会诱发甲状腺肿,杨梅:诱发甲状腺肿,木耳: 同食会得皮炎。,橘子:萝卜食后体内可产生一种抗甲状腺物质硫氰酸，阻碍甲状腺对碘的摄取。橘子能加强硫氰酸对甲状腺的抑制作用，从而诱发或导致甲状腺肿大。,蛇肉:同食会中毒。,人参:不易消化，腹里胀气。
罗汉果|西洋菜:止咳化痰|
芦笋|大花蟹:强化骨骼 ,帝王蟹:强化骨骼,青蟹:强化骨骼,大闸蟹:强化骨骼,百合:抗癌,白果:有润肺定喘,猪肉:有利于人体维生素B12的吸收|瓠瓜:加重脾胃虚寒 ,西葫芦:加重脾胃虚寒
鲈鱼|豆腐:增加蛋白质的吸收|奶酪:引发痼疾 
绿豆芽|鲫鱼 :通乳汁|猪肝:有损营养素的吸收
绿豆|燕麦:控制血糖含量,豇豆:豇豆和绿豆同煮汤饮服，具有清热解毒的功效，适用于小儿夏季生痱子、小疖肿等病症。,燕麦片:控制血糖含量,南瓜:保健作用|狗肉:一起吃会胀破肚皮 ,鱼头:维生素B族破坏 ,冬虫夏草:导致冬虫夏草的营养流失 ,圣女果:同食伤元气 
鳗鱼|豆腐:增加蛋白质的吸收 |牛肝:二者起生化反应，不利于健康 ,白果:鳗鱼产生不利于人体的生化反应,羊肝:减少营养素的吸收
毛豆|丝瓜:清热祛痰防止便秘口臭|鱼头:维生素B族破坏 ,桂鱼:维生素B族破坏 ,蕨菜:影响营养素的吸收 
米醋|鲤鱼:利湿|
蘑菇|荷兰豆:消除油脂引起的食欲不佳,豌豆:消除油腻引起的食欲不佳,木瓜:降脂降压,鸡翅:促进蛋白质的吸收,火腿:益气补脾，润燥化痰,五花肉:益气补脾，润燥化痰,排骨:益气补脾，润燥化痰|
牛肚|白菜:增强体质|
牛里脊|芋头:养血补血,茭白:催乳汁,香菇:易于消化,菜花:帮助吸收维生素B12,土豆:保护胃黏膜,生姜:驱寒、治腹痛,芹菜:营养瘦身,南瓜:健胃益气|海螺:身体不适,鲶鱼:同食会引起中毒,橘子:不利于营养素的吸收,猪肉:性味有所抵触,红糖:不利于营养的吸收、腹胀,田螺:不易消化、腹胀,韭菜:中毒,板栗:同食削弱栗子的营养价值、不易消化
牛奶|黑豆:帮助人体更好地吸收牛奶中的维生素B12,蜂蜜:缓解贫血和痛经 ,甘蔗:能够降低甘蔗汁的寒性,桃:滋养皮肤,香蕉:提高维生素B12的吸收,草莓:有助于维生素B12的吸收,木瓜:美容养颜|橘子:引起胃炎或胃蠕动异常 ,番茄酱:降低营养素的吸收率 ,金针菇:消化不良 ,西兰花:影响钙的吸收 ,空心菜:影响钙质的吸收 ,香椿:腹胀,菠菜:一起吃会引起痢疾 ,金桔:同食会影响消化吸收，还会引起腹胀、腹痛、腹泻等症状，另外，胃肠、肾、肺功能虚寒者不可多吃，以免诱发腹痛、腰膝酸软等症。,枣:同食影响蛋白质的吸收,橙子:影响消化，引起腹胀、腹痛、腹泻,桔子:影响消化，引起腹胀、腹痛、腹泻,杨梅:影响蛋白质消化吸收,菠萝:身体不适,猕猴桃:影响消化吸收，出现腹胀、腹痛、腹泻,醋:同食会引起腹中病结，可以用地浆水治疗。,巧克力:这两者同食易结成不溶性草酸钙，不仅影响吸收，还会出现头发干枯、腹泻、缺钙和生长发育缓慢等现象。,韭菜:牛奶中含钙。牛奶与含草酸多的韭菜混合食用,就会影响钙的吸收。,菜花:牛奶含丰富的钙质，菜花所含的化学成份影响钙的消化吸收。,鸡蛋:鸡蛋里的某种蛋白会和牛奶里的某中营养成分相互反应，使营养价值下降，所以不宜同食。
牛腩|菜花:帮助吸收维生素B12,土豆:保护胃黏膜,芋头:养血补血,香菇:易于消化,南瓜:健胃益气|栗子:引起呕吐,红糖:腹胀,板栗:引起呕吐
牛蒡|藕:排毒,肥牛:同食可刺激胃肠蠕动，改善便秘等症状|
糯米|蜜豆:能改善脾虚腹泻和水肿。,红豆:改善脾虚腹泻和水肿 ,百合:改善气血消除疲劳 ,赤小豆:改善脾虚腹泻和水肿,桂花:食欲不佳，腹胀腹泻有一定缓解作用,枣:可以治疗由阳虚引起的胃部隐痛,乌鸡:滋阴补肾|苹果:不易消化 ,莲子:影响钙的吸收 ,鸡胸肉:引起身体不适 ,鸡翅:引起身体不适,仔鸡:消化不良,鸡肉:同食会引起身体不适。
藕|红螺:补气,海螺:补气,牛蒡:排毒,虾米:养血补血,虾:改善肝脏功能,皮皮虾:改善肝脏功能,鲢鱼:美容,黄鳝:滋阴健脾,猪肉:健胃壮体|白萝卜:生食寒性较大
排骨|紫菜:滋阴润燥,大蒜:增进营养元素吸收,丝瓜:均衡营养,山楂:提高蛋白质的利用率，易消化,蘑菇:益气补脾，润燥化痰,冬瓜:蛋白更易吸收,洋葱:滋阴润燥,萝卜:更容易消化吸收,茄子:提高抵抗力,南瓜:降低血糖,白菜:滋阴润燥|菊花:中毒,百合:中毒,香菜:耗气,菱角:易造成腹痛,黄豆:胀气,鲫鱼:滞气,鹌鹑:使人面色发黑,田螺:不利于肠胃，造成脱发,甘草:不利于肠胃,杏仁:引起腹痛
苹果|青鱼:治疗腹泻,黄鱼:有助于营养的全面补充,芦荟:生津止渴、健脾益胃、消食顺气等功效,银耳:润肺止咳|紫甘蓝:影响维生素的吸收 ,糯米:不易消化 ,沙丁鱼:身体不适
平菇|豆腐:增加蛋白质的吸收,西兰花:防癌抗癌,韭黄:对增进食欲，缓解消化不良有效，还可解毒 ,冬瓜:利湿|驴肉:易引发心绞痛
皮皮虾|燕麦:护心解毒,丝瓜:润肺补肾美肤,藕:改善肝脏功能|葡萄:身体不适 ,乌鸡:中毒 ,西红柿 :产生砒霜会中毒 ,南瓜:痢疾,洋葱:形成草酸钙产生结石,西瓜:腹痛、腹泻、恶心,木瓜:腹痛头晕，食物中毒
葡萄|虾仁:降低蛋白质的营养价值|螃蟹:身体不适 ,皮皮虾:身体不适 ,虾:身体不适 
芡实|鸡胗:治遗精|
千张|带鱼 :补钙,白萝卜:有利于消化|
茄子|海虾:营养非常高，具有健脾宁心，降压止血的作用。比较适用于动脉硬化，高血压，脑血栓形成和坏血病患者食用,北极虾:营养非常高，具有健脾宁心，降压止血的作用。比较适用于动脉硬化，高血压，脑血栓形成和坏血病患者食用 ,明虾 :营养非常高，具有健脾宁心，降压止血的作用。比较适用于动脉硬化，高血压，脑血栓形成和坏血病患者食用,基围虾:营养非常高，具有健脾宁心，降压止血的作用。比较适用于动脉硬化，高血压，脑血栓形成和坏血病患者食用 ,菠菜:加快血液循环预防癌症,苦瓜:对缓解心血管疾病有良好功效 ,羊排:两者同食能够有效预防心血管病患的发生,肥牛:同食可以强壮身体,火腿:提高抗病力 ,五花肉:可提高没免疫力,排骨:提高抵抗力,猪肉:降低胆固醇的吸收稳定血糖|黑鱼:同食有损肠胃,河蟹:一起吃会中毒，可以用藕节治疗 ,螃蟹:二者一起吃，伤人肠胃 ,墨鱼:同食容易引起霍乱。
芹菜|海虾:够促进人体代谢新陈，改善机体微循环 ,北极虾 :够促进人体代谢新陈，改善机体微循环,明虾:够促进人体代谢新陈，改善机体微循环,基围虾:够促进人体代谢新陈，改善机体微循环,香芋:二者同食可补气虚，增食欲，对身体大有裨益,红薯:降血压,核桃:润发明目养血,羊排:同食对儿童生长发育极为有利,牛里脊:营养瘦身,牛肉:营养瘦身|河蚬:破坏维生素B1 ,文蛤:影响维生素的吸收 ,虾米:将所含的维生素B1全部破坏,虾:伤元气 ,河蟹:影响蛋白质的吸收 ,蛤蜊:影响维生素的吸收 ,螃蟹:一起吃会影响蛋白质的吸收 ,牡蛎:降低锌的吸收 ,醋:损伤牙齿 ,黄豆:降低铁的吸收 ,黄瓜:芹菜中的维生素C将会被分解破坏，降低营养价值,兔肉:一起吃会脱水,鸡肉:一起吃会伤元气,鸡胸肉:一起吃会伤元气,甲鱼:同食会中毒。,菊花:同食会引起呕吐
青萝卜|紫菜: 清肺热治咳嗽,豆腐:帮助人体吸收豆腐中的营养|木耳:引发皮炎 
青蒜|莴笋:防止高血压 |
青蟹|枸杞:补肾壮阳 ,芦笋:强化骨骼,冬瓜:养精益气|苋菜:肠胃积滞 ,石榴:腹疼，呕吐、恶心 ,橘子:气滞肚胀 ,南瓜:中毒 ,柚子:刺激肠胃 ,红薯:胆结石 ,甜瓜:腹泻 ,柿子:腹泻、腹痛，中毒 ,梨:不利于肠胃 ,猕猴桃:中毒 
青鱼|苹果:治疗腹泻,韭菜:治疗脚气 ,银耳:滋补身体|西红柿:不利于营养成分的吸收 ,李子:引起身体不适
秋刀鱼|豆腐:促进钙的吸收|枣:令人腰腹作痛 
桑葚|小米面:同食具有保护心血管的功效,蜂蜜:可滋阴补血、适用于阴血亏虚所致的须发早白、头目晕眩、女子月经不调、闭经等。,醋:预防感冒、益肾、帮助消化、预防便秘等功效 ,粳米:同食可补肝益肾、养血润燥、消除脑力疲劳、常吃有利于记忆力减退、精力不集中、多梦、失眠等症状的改善。|鸭蛋:同食可能导致胃癌,鸭肉:同食可能导致胃癌
三文鱼|西红柿:滋润肌肤抗衰老,圣女果:滋润肌肤抗衰老|
山药|扁豆:补脾益肾,玉米:吸收更多的营养素,银耳:滋阴润肺,莲子:健脾补肾,甘蔗:咳嗽有痰者，二者同食对身体非常有好处,枣:同食对脾胃虚弱、饮食减少、消化不良及营血虚亏有一定作用,鸭肉:补阴养肺,鸭腿:滋阴补肺的作用,鸭翅:滋阴补肺的作用,鸡胗:治小儿脾虚疳积,乌鸡:滋补,羊排:具有补血，养颜，强身，通便等作用|虾:同食会引起腹痛、恶心、呕吐等症状。,笋瓜:胡萝卜中含维生素c分解酶，若山药同食，维生素c则被分解破坏。,鹿肉:生涩易便秘,荞麦米:身体不适,鲫鱼:同食会引起腹痛、恶心、呕吐等症状。,鲤鱼:同食会引起腹痛、恶心、呕吐等症状。,黄瓜:黄瓜中含维生素c分解酶，若山药同食，维生素c则被分解破坏。,南瓜:南瓜中皆含维生素c分解酶，若山药同食，维生素c则被分解破坏。,猪肝:山药富维生素c，猪肝中含铜、铁、锌等金属微量元素，维生素c遇金属离子，则加速氧化而破坏，降低了营养价值，故食猪肝后，不宜食山药。
山楂干|枸杞:补肝益肾 ,杜仲:降血压|柠檬:影响消化,胡萝卜:维生素C则易被分解破坏,猪肝:加速氧化，会使维生素C和金属遭到破坏,海参:不易消化
山楂|枸杞:补肝益肾,杜仲:降血压,火腿:能够提高蛋白质的利用率，更易消化,五花肉:提高蛋白质的利用率，易消化,排骨:提高蛋白质的利用率，易消化|鱼头:腹痛、恶心、呕吐 ,桂鱼:腹痛、恶心、呕吐 ,笋瓜:身体不适,海参:不易消化,柠檬:影响消化,猪肝:山楂含维生素C丰富，猪肝含有较多的铜、铁、锌等金属微量元素；维生素C遇到金属离子，则加速氧化，会使维生素C和金属都遭到破坏,胡萝卜:胡萝卜富含维生素C分解酶，若含有丰富的维生素C的山楂与含有维生素C分解酶的食物同用，维生素C则易被分解破坏。
山竹|榴莲:消火|豆浆:身体不适,白菜:身体不适 ,冬瓜:身体不适,苦瓜:身体不适,西瓜:身体不适
生姜|羊排:同食可以治冷寒腹疼,牛里脊:驱寒、治腹痛,牛肉:驱寒、治腹痛|兔肉:寒热一起吃，易致腹泻,肥牛:同食会上火
圣女果|三文鱼:滋润肌肤抗衰老,圆白菜:预防癌症促进血液循环,菜花:降血脂降血压|虾:产生砒霜会中毒 ,螃蟹:同食引起腹泻 ,红薯:同食会得结石病、呕吐、腹痛、腹泻 ,绿豆:同食伤元气 ,猪肝: 猪肝使维生素C氧化脱氧，使其失去原来的抗坏血酸功能 ,黄瓜:破坏维生素C的吸收,土豆:导致食欲不佳消化不良
首乌|鸡肉:一起吃有补肝养血，滋肾益精的功效,黑鱼:可以治疗疮疡，瘰疬，精血不足，便秘等症,乌鸡:滋阴清热，调经活血|猪肉:身体不适 ,猪血:一起吃会引起身体不适 ,白萝卜:身体不适 ,羊肉:身体不适 ,萝卜:性寒滑 
水芹菜|牛肉:营养瘦身,红薯:降血压,豆腐:清肠排毒,核桃:润发明目养血 |虾米:将所含的维生素B1全部破坏 ,虾:伤元气 ,河蟹:影响蛋白质的吸收 ,蛤蜊:影响维生素的吸收 ,甲鱼:一起吃会中毒，可以用橄榄汁解毒 ,螃蟹:一起吃会影响蛋白质的吸收 ,牡蛎:降低锌的吸收 ,醋:损伤牙齿 ,兔肉:一起吃会脱水 ,黄豆:降低铁的吸收 ,黄瓜:芹菜中的维生素C将会被分解破坏，降低营养价值 
丝瓜|桂鱼:营养均衡,海虾:辅助治疗肺虚咳嗽，体倦，腰膝酸软等病患 ,北极虾 :辅助治疗肺虚咳嗽，体倦，腰膝酸软等病患 ,明虾:辅助治疗肺虚咳嗽，体倦，腰膝酸软等病患,基围虾:辅助治疗肺虚咳嗽，体倦，腰膝酸软等病患,虾:润肺补肾美肤,毛豆:清热祛痰防止便秘口臭,皮皮虾:润肺补肾美肤,鸡蛋:润肺补肾美肤 ,火腿:营养均衡,五花肉:营养均衡,排骨:均衡营养|白萝卜:伤元气
松子|玉米:防癌抗癌,枣:养颜益寿、减少皮肤病 ,鸡肉:增加抵抗力,鸡胸肉:增加抵抗力,仔鸡:增强抵抗力|
蒜苗|莴笋:防止高血压|
酸奶|蓝莓:壮骨，增加免疫力|黄豆:酸牛奶含丰富的钙质，黄豆所含的化学成份影响钙的消化吸收 ,鱼籽:不易消化 ,香蕉: 同食易产生致癌物。
蒜薹|乌鸡:预防高血压,猪肝:缓解大脑疲劳|韭菜: 影响消化 
粟米|甘蔗:适用于脾肺不足、阴虚肺燥、烦热咳嗽、咽喉不利等症 |
苔菜|黄鱼:提供较高的营养成分,有润肺健脾、补气活血、清热解毒之功效。对产后体弱虚损、腰肌劳损有一定作用|
茼蒿|鸡蛋:帮助充分吸收维生素A,蜂蜜:预防便秘 ,鸡肉:帮助充分吸收维生素A ,鸡胸肉:帮助充分吸收维生素A,仔鸡:充分吸收维生素A|柿子:同食容易易伤胃。
土豆|豆角:防止急性肠胃炎呕吐腹泻,豇豆:豇豆的营养成分能够让人头脑宁静,并且能够对消化系统进行调理,能消除胸膈胀满，所以豇豆和土豆搭配,可以防治急性肠胃炎、防治呕吐、腹泻等,牛里脊:保护胃黏膜,肥牛:同食不仅味道好，并且马铃薯富含叶酸，有着保护胃黏膜的功效。,牛腩:保护胃黏膜,牛肉:保护胃黏膜|圣女果:导致食欲不佳消化不良,柿子:吃了土豆，人的胃里会产生大量盐酸，如果再吃柿子，柿子在胃酸的作用下会产生沉淀，既难消化，又不易排出。,香蕉:同食面部会生斑。,西红柿:土豆会在人体的胃肠中产生大量的盐酸。西红柿在较强的酸性环境中会产生不溶于水的沉淀，从而导致食欲不佳，消化不良。,石榴:同食会引起中毒，可以用韭菜水解毒。
豌豆|蘑菇:消除油腻引起的食欲不佳,玉米:蛋白质互补|醋:消化不良 
莴苣|肥牛:同食有调理气血的作用|藕带:同食会造成多类营养元素被破坏 
莴笋|青蒜 :防止高血压 ,蒜苗:防止高血压,芸豆:补钙|蜂蜜:不利肠胃，易致腹泻,奶酪:乳酪是油脂性食物，而莴苣性寒，二者同食，容易导致消化不良，或腹痛腹泻。同时，莴苣生食时，因洗涤不净，易受寄生虫污染，如钩虫、蛔虫等，
无花果|西洋菜:止咳化痰|
五花肉|紫菜:滋阴润燥,大蒜:可增进营养元素的吸收,丝瓜:营养均衡,山楂:提高蛋白质的利用率，易消化,蘑菇:益气补脾，润燥化痰,冬瓜:利于蛋白质的消化吸收,洋葱:滋阴润燥,萝卜:易消化吸收,茄子:可提高没免疫力,南瓜:降低血糖,白菜:滋阴润燥|杏仁:造成腹痛,甘草:不利于肠胃,田螺:容易伤肠胃，并造成脱发,菊花:中毒,百合:中毒,香菜:耗气,菱角:易造成腹痛,鲫鱼:滞气,鹌鹑:使面色发黑
乌鸡|首乌:滋阴清热，调经活血,山药:滋补,糯米:滋阴补肾,黑木耳:活血补血,枣:滋阴补血,蒜薹:预防高血压,芸豆:补钙|皮皮虾:中毒 ,鲫鱼:中毒,兔肉:中毒,虾:中毒
虾米|紫甘蓝:强壮身体防癌抗病,藕:养血补血|水芹菜:将所含的维生素B1全部破坏 ,芹菜:将所含的维生素B1全部破坏
苋菜|鸡蛋:增强人体免疫力,猪肝:增强人体免疫力|大花蟹:肠胃积滞 ,青蟹:肠胃积滞 ,大闸蟹:肠胃积滞 ,梭子蟹:肠胃积滞 ,甲鱼:一起吃难以消化 ,山葵:中毒 
香菜|羊排:同食对身体虚弱，阳气不足，性冷淡，阳痿症病人有不错的食疗作用,羊肉:去腥 ,羊骨:去腥|梅花肉:耗气伤身,黄瓜:破坏维生素C,猪肝:身体不适,火腿:耗气伤身,五花肉:耗气,排骨:耗气,猪肉:伤身
香干|白萝卜:有利于消化,带鱼:补钙 |蜂蜜:有损听力，腹泻 ,小葱:影响钙质吸收 
香菇|牛肉酱:易于消化,薏米:健脾利湿、理气化痰的功效,鳕鱼:补脑健脑,鲤鱼:提供全面的营养,油菜:防止便秘,荸荠:益胃助食,木瓜:降压减脂,鸡腿:提供高质量蛋白质,仔鸡:改善便秘,牛里脊:易于消化,牛腩:易于消化|鹌鹑蛋:面部易长黑斑 ,河蟹:易引起结石症状 ,基围虾:香菇含有大量异种蛋白，容易引起过敏，而香菇又被列为气喘的引起物之一，两者不宜搭配同吃，哮喘病人尤要注意 ,明虾:香菇含有大量异种蛋白，容易引起过敏，而香菇又被列为气喘的引起物之一，两者不宜搭配同吃，哮喘病人尤要注意 ,北极虾:香菇含有大量异种蛋白，容易引起过敏，而香菇又被列为气喘的引起物之一，两者不宜搭配同吃，哮喘病人尤要注意 ,海虾:香菇含有大量异种蛋白，容易引起过敏，而香菇又被列为气喘的引起物之一，两者不宜搭配同吃，哮喘病人尤要注意 ,西红柿:破坏类胡萝卜素 
香蕉|燕麦片:提高血清素含量，改善睡眠,牛奶:提高维生素B12的吸收,燕麦:提高血清素含量，改善睡眠 ,苹果:防止铅中毒|香芋:同食会使胃不适，感觉胀痛,红薯:一起吃会引起身体不适,芋头:同食会使胃不适，感觉胀痛。 ,土豆:同食面部会生斑。,酸奶: 同食易产生致癌物。
香芋|芹菜:二者同食可补气虚，增食欲，对身体大有裨益,粳米:有散结宽肠、健脾强肾、下气等作用，常食可养颜，适用于大便干燥、便结等症,大枣:大枣具有健脾、益气、补血的功效，能够使血脉通畅，增加皮肤的营养，两者搭配在一起，相得益彰,猪肉:同食对保健和预防糖尿病有较好的作用,牛肉:养血补血，还可以防治食欲不振及便秘,防止皮肤老化|香蕉:同食会使胃不适，感觉胀痛
小白菜|辣椒:促进食欲、帮助消化,猪肉:增强体质|秋黄瓜:破坏维生素C ,黄瓜:破坏维生素C,兔肉:同食容易引起腹泻和呕吐。
小龙虾|燕麦:护心解毒|洋葱:形成草酸钙产生结石
小麦|玉米:提高蛋白质的吸收|小米面:同食对人的脾胃不好，脾胃虚弱者尤要注意 
小米面|粳米:同食可提高营养价值,桂圆:同食有益丹田，补虚损，开肠胃之作用,黄豆:同食可提高蛋白质的吸收利用率,红糖:同食可以健脾胃，补虚损，排除淤血，补充失血 ,桑葚:同食具有保护心血管的功效,鸡蛋:同食用有补脾胃，益气血，活血脉的作用|小麦:同食对人的脾胃不好，脾胃虚弱者尤要注意 ,杏仁:腹泻、呕吐 
小米|黄豆:有利于营养素的吸收,猪心:有助于睡眠,红糖:补虚补血,鸡蛋:整体改善蛋白质的吸收。,大豆:小米的氨基酸中缺乏赖氨酸，而大豆的氨基酸中富含赖氨酸，可以补充小米的不足|杏仁:腹泻、呕吐
虾仁|葡萄:降低蛋白质的营养价值,圆白菜:能强壮身体,防病抗病|
虾|燕麦片:护心解毒,燕麦: 护心解毒,辣椒:提高人体免疫力、具有开胃、消食、壮阳的作用,丝瓜:润肺补肾美肤,藕:改善肝脏功能|葡萄:身体不适 ,圣女果:产生砒霜会中毒 ,西红柿:产生砒霜会中毒 ,水芹菜:伤元气 ,芹菜:伤元气 ,山药:同食会引起腹痛、恶心、呕吐等症状。,洋葱:形成草酸钙产生结石,橙子:同食会引起中毒、危及生命,西瓜:腹痛、腹泻、恶心,木瓜:腹痛头晕，食物中毒,乌鸡:中毒,南瓜:同食会引起痢疾。
西葫芦|豆腐:减肥美容 |芦笋:加重脾胃虚寒
西兰花|腊肠:可减少致癌物生成,金针菇:防癌抗癌,平菇:防癌抗癌,鳕鱼:防癌抗癌 |牛奶:影响钙的吸收 
杏仁|西洋菜:止咳化痰 ,白果:健脾固肾，收涩止带|梅花肉:腹痛,小米面:腹泻、呕吐 ,猪里脊:腹痛,小米:腹泻、呕吐,黄芪:身体不适,葛根:身体不适,板栗:一起吃会胃痛,猪肺:影响蛋白质的吸收,猪蹄:腹痛,火腿:易导致腹痛,五花肉:造成腹痛,排骨:引起腹痛,猪肉:一起吃会引起肚子痛,栗子: 同食会胃痛。
西芹|腐竹:抗疲劳 |
西洋菜|无花果:止咳化痰,杏仁:止咳化痰 ,罗汉果:止咳化痰|
鳕鱼|豆腐:蛋白质的吸收率,香菇:补脑健脑,西兰花:防癌抗癌 |
鸭翅|山药:滋阴补肺的作用,豆豉:降低人体的脂肪含量|李子:伤五脏,木耳:身体不适,栗子:影响营养吸收,甲鱼:水肿腹泻
鸭蛋|银耳:滋肾补脑|甲鱼:二物皆属凉性，不宜一起吃 ,桑葚:同食可能导致胃癌,李子:同食会引起中毒。
洋葱|苦瓜:提高机体的免疫力,鸡蛋:提高人体对维生素c和维生素E的吸收率 ,大蒜:防癌抗癌抗菌消炎,羊排:两者同食能够有效增强机体免疫力,火腿:滋阴润燥,五花肉:滋阴润燥,排骨:滋阴润燥|虾:形成草酸钙产生结石,河虾:形成草酸钙产生结石,小龙虾:形成草酸钙产生结石,皮皮虾:形成草酸钙产生结石,蜂蜜:同食会伤眼睛，引起眼睛不适，严重会失明。
羊骨|刀豆:补肾壮阳 ,海参:养血润燥,香菜:去腥,白萝卜:消积滞、化痰热,豆腐:清热泻火、除烦、止渴 |赤小豆:同食会引起中毒,百合:腹泻,奶酪:二者功能相反，不宜一起吃,板栗:二者都不易消化，同炖共炒都不相宜，甚至可能同吃还会引起呕吐,鲳鱼:影响营养素的吸收,梅干菜:一起吃会引起胸闷,海螺:腹泻,南瓜子:可能会引起腹胀、胸闷等症,竹笋:一起吃会引起中毒，可以用地浆水治疗,豌豆苗:易发生黄疸和脚气病,西瓜:伤元气,醋:羊肉大热，功能益气补虚；醋中含蛋白质、糖、维生素、醋酸及多种有机酸，其性酸温，消肿活血，应与寒性食物配合，与羊肉不宜,南瓜:两补同时，令人肠胃气壅
羊排|香菜:同食对身体虚弱，阳气不足，性冷淡，阳痿症病人有不错的食疗作用,萝卜:同食有比较好的益智健脑的作用，具有助阳，补精，消食，顺气的作用，使补而不滞，适于身体虚弱的人食用。,白果:具有温补肺气，止咳的作用,辣椒:同食可去除羊肉的膻味,豆腐:能够补充人体多类微元素，并且还能够起到清热泻火，除烦，止渴的作用。 ,枸杞:比较适用于肾精衰败，腰背疼痛，性功能减退等。,山药:具有补血，养颜，强身，通便等作用,芹菜:同食对儿童生长发育极为有利,鸡蛋:搭配食用可滋补身体，增强新陈代谢,生姜:同食可以治冷寒腹疼,胡萝卜:同食适于营养不良、贫血、头晕、大便干燥的病人、可以补虚益气、增进血液循环、提高御寒能力，还能帮助消化、补肾壮阳。,柠檬:同食可除掉羊肉的膻味，使食物味道极佳,胡椒面:同食具有温肺化痰的作用,茄子:两者同食能够有效预防心血管病患的发生,洋葱:两者同食能够有效增强机体免疫力|醋:同食会助热发燥，并且还影响羊肉的味道,栗子:会造成胃肠不适感，呕吐,绵白糖:会能降低羊肉的营养价值并且阻碍铜的吸收,梨:同食会造成腹泻，消化不良,荞麦:两者功能反之，最好不要搭配一起吃,竹笋:同食会引起中毒,豆瓣酱:两者功能反之，提议最好不要搭配一起吃,西瓜:同食会损伤元气,赤小豆:两者功能反之，因此不宜搭配一起吃。,菖蒲:同食会降低羊肉的营养价值,南瓜:两者同食会令肠胃气壅，也许造成消化不良,乳酪:同食也许会产生不良生化反应
杨桃|精盐:有助于维持人体的酸碱平衡,菠菜:可防止细胞氧化，还有助于防老抗癌|石榴:同食易上火,芝士:腹泻
燕麦片|虾:护心解毒,绿豆:控制血糖含量,香蕉:提高血清素含量，改善睡眠,黄豆:预防贫血,冬菇:有助于防癌、抗衰老 |
燕麦|绿豆:控制血糖含量,虾: 护心解毒,河虾:护心解毒,小龙虾:护心解毒,皮皮虾:护心解毒,对虾:护心解毒,香蕉:提高血清素含量，改善睡眠 |
鸭肉|白菜:促进血液中胆固醇的代谢,豆豉:降低人体脂肪,栗子:影响营养吸收,山药:补阴养肺|桑葚:同食可能导致胃癌,李子:中毒，伤五脏,木耳:会造成身体不适,甲鱼:久食令人阳虚，水肿腹泻,大蒜:中毒
鸭腿|白菜:促进血液中胆固醇的代谢,山药:滋阴补肺的作用|
椰子|冬瓜:泻肺火|
薏米|白果:健脾除湿、清热排脓的作用,香菇:健脾利湿、理气化痰的功效,枣:活血养颜、减少面部蝴蝶斑、产后面色黒滞等问题|
益母草|金银花:清热解毒|
银耳|青鱼:滋补身体,菊花:润燥除烦 ,冰糖:滋补润肺,墨鱼:滋补肺阴 ,鸭蛋:滋肾补脑,山药:滋阴润肺,百合:滋阴润肺,苹果:润肺止咳,猪腰:补肾,枸杞:美容养颜|白萝卜:易患皮炎
樱桃|大葱:治疗麻疹,绵白糖:治疗慢性气管炎|杨梅:同食使人上火,胡萝卜:降低各自原有的营养价值,黄瓜:破坏维生素C，失去营养价值
银鱼|鸡蛋:增加蛋白质的吸收|红枣:令人腰腹作痛 
油豆腐|带鱼:补钙,海带:预防碘缺乏 ,白萝卜:有利于消化|蜂蜜:有损听力，腹泻
油麦菜|豆腐:镇痛催眠,芝麻酱:补充钙质|
鱿鱼|木耳:使肤质嫩滑,猪蹄:补气养血|番茄酱:加重肾脏负担 
圆白菜|圣女果:预防癌症促进血液循环,海米:补充碘,虾仁:能强壮身体,防病抗病,木耳:补肾壮骨、填精健脑、健脾通络,西红柿:益气生津、预防癌症促进血液循环,辣椒:促进胃肠蠕动、有利于营养物质吸收,胡萝卜:减少癌细胞的产生,猪肉:润肠胃生津健身|黄瓜:影响维生素C的吸收
玉米面|菜花:健脾益胃、补虚、助消化 ,大蒜:养心健胃,苦瓜:清热解暑|牡蛎:影响锌的吸收 ,田螺:一起吃容易中毒，用地浆水可以解毒 ,海螺:身体不适 
玉米|豌豆:蛋白质互补,豇豆:玉米粥对于脾胃虚弱、尿频遗精、动脉硬化、冠心病、高血脂、高血压病人有着很好的食疗效果，适合这些患者长期食用，玉米粥配上,小麦:提高蛋白质的吸收,鸡蛋:防止胆固醇过高,鸽子:防治神经衰弱,山药:吸收更多的营养素,松子:防癌抗癌|红螺:身体不适 ,扇贝:降低锌的吸收量 ,海螺:身体不适,田螺:同食容易中毒。
芸豆|豆腐:适宜慢性肝炎,莴笋:补钙,乌鸡:补钙,猪肉:提高维生素B12的吸收率|田螺:引起结肠癌 
芋头|牛里脊:养血补血,肥牛:具有益气补中，通便的作用。,牛腩:养血补血,牛肉:养血补血|香蕉:同食会使胃不适，感觉胀痛。 
枣|木耳:同食有补血、调经的作用,糯米:可以治疗由阳虚引起的胃部隐痛,红豆:同食起到补益、心脾、消肿、利水的功效,山药:同食对脾胃虚弱、饮食减少、消化不良及营血虚亏有一定作用,松子:养颜益寿、减少皮肤病 ,核桃:提供全面的营养物质、具有美容养颜作用,荔枝:同食具有健脾止泻的作用,大麦:同食可以增进营养吸收,薏米:活血养颜、减少面部蝴蝶斑、产后面色黒滞等问题,栗子:适于肾虚、腰酸背痛者、腿脚无力者、小便频多者,鲤鱼:滋补暖胃、强心补血,花生:补虚、止血,乌鸡:滋阴补血|沙丁鱼:身体不适 ,秋刀鱼:令人腰腹作痛 ,鱼头:消化不良 ,桂鱼:消化不良 ,海蟹:易患寒热病,牛奶:同食影响蛋白质的吸收,萝卜:破坏维生素 C,黄瓜:破坏维生素 C,鲶鱼:导致头发脱落,虾皮:同食会中毒,大葱:同食易使火气更大
章鱼|木瓜:通乳汁|柿子:腹泻
芝麻酱|油麦菜:补充钙质|
芝麻|海带:血液循环净化血液降低胆固醇,核桃:改善皮肤弹性，保持皮肤细腻|鸡胸肉:严重会导致死亡,鸡肉:一起吃严重会导致死亡,鸡腿:影响维生素的吸收,鸡翅:严重会导致死亡
猪肝|青椒:补血,芥菜:有助于钙的吸收,苋菜:增强人体免疫力,菠菜:防治贫血,蒜薹:缓解大脑疲劳,生菜:补充全面营养,白菜:滋补,大白菜:滋补|藕带:同食会降低人体对铁、铜、锌等元素的吸收 ,圣女果: 猪肝使维生素C氧化脱氧，使其失去原来的抗坏血酸功能 ,辣椒:同食降低营养价值,山楂干:加速氧化，会使维生素C和金属遭到破坏,鲫鱼:一起吃具有刺激作用，疮痈热病者忌食,山楂:山楂含维生素C丰富，猪肝含有较多的铜、铁、锌等金属微量元素；维生素C遇到金属离子，则加速氧化，会使维生素C和金属都遭到破坏,黄豆芽:有损营养素的吸收,沙丁鱼:身体不适,山药:山药富维生素c，猪肝中含铜、铁、锌等金属微量元素，维生素c遇金属离子，则加速氧化而破坏，降低了营养价值，故食猪肝后，不宜食山药。,绿豆芽:有损营养素的吸收,鹌鹑蛋:面生黑斑,香菜:身体不适,鲤鱼:同食会影响消化。,荞麦:同食会影响消化。,西红柿:西红柿富含维生素C，猪肝使维生素C氧化脱氧，使其失去原来的抗坏血酸功能。,菜花:菜花含有大量纤维素，纤维素中的醛糖酸残基可与猪肝中的铁、铜、锌等微量元素形成螯合物而降低人体对这些元素的吸收。,豆芽: 猪肝中的铜会加速豆芽中的维生素C氧化，失去其营养价值。
猪肉|香芋:同食对保健和预防糖尿病有较好的作用,芦笋:有利于人体维生素B12的吸收,芸豆:提高维生素B12的吸收率,大蒜:促进血液循环、消除疲劳,小白菜:增强体质,藕:健胃壮体,茄子:降低胆固醇的吸收稳定血糖,白菜:补充营养通便,冬笋:补肝肾,菜花:提高蛋白质的吸收率,圆白菜:润肠胃生津健身,魔芋:滋补营养,南瓜:预防糖尿病,大白菜:补充营养通便|红螺:身体不适 ,基围虾:耗人阴精，造成阴虚火旺，不利于身体健康 ,明虾:耗人阴精，造成阴虚火旺，不利于身体健康 ,北极虾:耗人阴精，造成阴虚火旺，不利于身体健康 ,海虾:耗人阴精，造成阴虚火旺，不利于身体健康 ,首乌:身体不适 ,牛里脊:性味有所抵触,鹌鹑:面生黑斑,刀豆:易发生腹胀，腹泻,梨:伤肾脏,菊花:一起吃严重会导致死亡,海螺:身体不适,羊肝:共烹炒易产生怪味,荞麦:脱发,牛排:性味有所抵触,香菜:伤身,杏仁:一起吃会引起肚子痛,杏:腹痛,雪花梨:伤肾脏,鲫鱼:二者起生化反应，不利于健康,黄豆:腹胀,鸭梨:伤肾脏,驴肉:腹泻,菠菜:减少铜的吸收,百合:一起吃会引起中毒,甘草:同食会引起中毒。,田螺:同食容易脱眉毛。
竹笋|木耳:清热泻火,鲍鱼: 营养全面，易于吸收|猪小排:影响钙的吸收 ,红糖: 形成赖氨酸糖基，对人体不利 ,糖浆:一起吃会引起中毒 ,羊骨:一起吃会引起中毒，可以用地浆水治疗,羊肝:一起吃会引起中毒,羊排:同食会引起中毒,羊肉:一起吃会引起中毒，可以用地浆水治疗
竹荪|鸡腿菇:提高营养素的吸收率,百合:润肺止咳|
猪蹄|花生:催乳,鱿鱼:补气养血|杏仁:腹痛,杏:腹痛,梨:伤肾脏,黄豆:腹胀
猪小排|红薯:增加营养素的吸收,冬瓜:祛湿|鲫鱼:影响营养素的吸收 ,竹笋:影响钙的吸收 ,苦瓜:形成草酸钙阻碍钙的吸收
猪腰|银耳:补肾|田螺:腹痛,白萝卜:影响消化
紫菜|鸡蛋:有利于营养素的吸收,青萝卜: 清肺热治咳嗽,紫甘蓝:能吸收到更高的营养,白萝卜:清肺热治咳嗽,火腿:滋阴润燥,五花肉:滋阴润燥,排骨:滋阴润燥|柿子:影响钙的吸收
紫甘蓝|虾米:强壮身体防癌抗病,鲤鱼:营养吸收更全面,紫菜:能吸收到更高的营养|苹果:影响维生素的吸收 
仔鸡|油菜:健肝,松子:增强抵抗力,茶树菇:增进蛋白质吸收,板栗:补血,豇豆:增进食欲,冬瓜:消肿清热利尿,茼蒿:充分吸收维生素A,香菇:改善便秘|芥末酱:助火热,鲍鱼:影响消化吸收,红薯:腹痛,菊花:中毒,李子:疟疾,糯米:消化不良,兔肉:腹泻
青椒|糙米:防止维生素C被氧化,鲳鱼:促进维生素C的吸收 ,苦瓜:抗衰老,鸡翅:补充维生素C,猪肝:补血,鸡蛋:缺乏维生素C是鸡蛋唯一的“短处”，搭配青椒等，就可以弥补。|黄瓜:破坏维生素C
生菜|豆腐:减肥健美,海带:促进铁的吸收,鸡蛋:滋阴润燥清热解毒,猪肝:补充全面营养|蜂蜜:一起吃易导致腹泻 ,积雪草:影响药效 
桃|牛奶:滋养皮肤|甲鱼:心痛
香椿|鸡蛋:润滑肌肤|牛奶:腹胀,菜花:因为香椿中含有丰富的钙质，而菜花中所含的化学成分会影响到钙质的消化和吸收。所以，香椿不适宜和菜花一同食用。 ,黄瓜:黄瓜中含有维生素C分解酶，会破坏到香椿中的维生素C，影响人体对维生素C的吸收，使营养大大降低，故香椿和黄瓜也不宜同食。
西红柿|三文鱼:滋润肌肤抗衰老,菜花:降血脂降血压,圆白菜:益气生津、预防癌症促进血液循环,鸡蛋:缺乏维生素C是鸡蛋唯一的‘短处’，搭配番茄就可以弥补。|青鱼:不利于营养成分的吸收 ,鱼头:影响铜的吸收 ,桂鱼 :影响铜的吸收 ,河蚌:变成砒霜 ,虾:产生砒霜会中毒 ,河蟹:一起吃会引起腹泻 ,皮皮虾:产生砒霜会中毒 ,螃蟹:产生砒霜会中毒 ,香菇:破坏类胡萝卜素 ,黄瓜:西红柿中含大量维生素C，有增强机体抵抗力、防治坏血病、抵抗感染等作用；而黄瓜中含有维生素C分解酶，一起吃可使其中的维生素C遭到破坏,红薯:一起吃会得结石病，呕吐、腹痛、腹泻,地瓜:同食会得结石病，呕吐、腹痛、腹泻。,土豆:土豆会在人体的胃肠中产生大量的盐酸。西红柿在较强的酸性环境中会产生不溶于水的沉淀，从而导致食欲不佳，消化不良。,胡萝卜:维生素C丰富的食品搭配合吃，就会把维生素C破坏。,猪肝:西红柿富含维生素C，猪肝使维生素C氧化脱氧，使其失去原来的抗坏血酸功能。
羊肉|辣椒:去除羊肉膻味,白果:温补肺气，止咳的作用,豆腐:清热泻火、除烦、止渴,白萝卜:消积滞、化痰热,香菜:去腥 ,海参:养血润燥,刀豆:补肾壮阳|红螺:腹泻 ,首乌:身体不适 ,豆苗:易发生黄疸和脚气病 ,栗子:二者都不易消化，同炖共炒都不相宜，甚至可能同吃还会引起呕吐,南瓜:两补同时，令人肠胃气壅,西瓜:伤元气,豌豆苗:易发生黄疸和脚气病,竹笋:一起吃会引起中毒，可以用地浆水治疗,南瓜子:可能会引起腹胀、胸闷等症。,海螺:腹泻,鲳鱼:影响营养素的吸收,板栗:二者都不易消化，同炖共炒都不相宜，甚至可能同吃还会引起呕吐,奶酪:二者功能相反，不宜一起吃,百合:腹泻,赤小豆:同食会引起中毒,醋:羊肉大热，功能益气补虚；醋中含蛋白质、糖、维生素、醋酸及多种有机酸，其性酸温，消肿活血，应与寒性食物配合，与羊肉不宜。,梅干菜:同食回引起胸闷。
油菜|海虾:可提供更多人体所需的钙质 ,北极虾:可提供更多人体所需的钙质,明虾:可提供更多人体所需的钙质,基围虾:可提供更多人体所需的钙质,豆腐:清肺止咳,香菇:防止便秘,金针菇:预防大肠癌和胃癌,鸡肉:强化肝脏美化肌肤 ,鸡胸肉:强化肝脏美化肌肤 ,鸡爪:促进胶原蛋白的吸收,仔鸡:健肝|黄瓜:降级维生素C的吸收,南瓜:降低维生素C的吸收
